SCTP -> Sctp
SCTPAddIPCorrelatedTypes -> SctpAddIpCorrelatedTypes
SCTPAlg -> SctpAlg
SCTPAlgStateVariables -> SctpAlgStateVariables
SCTPAlgorithm -> SctpAlgorithm
SCTPAsconfAckChunk -> SctpAsconfAckChunk
SCTPAsconfChunk -> SctpAsconfChunk
SCTPAssociation -> SctpAssociation
SCTPCCModules -> SctpCcModules
SCTPChunkTypes -> SctpChunkTypes
SCTPClient -> SctpClient
SCTPCommand -> SctpCommand
SCTPConnectInfo -> SctpConnectInfo
SCTPDataVariables -> SctpDataVariables
SCTPErrorCauses -> SctpErrorCauses
SCTPErrorChunk -> SctpErrorChunk
SCTPErrorCode -> SctpErrorCode
SCTPErrorInfo -> SctpErrorInfo
SCTPEventCode -> SctpEventCode
SCTPFlags -> SctpFlags
SCTPGapList -> SctpGapList
SCTPIncomingSSNResetRequestParameter -> SctpIncomingSsnResetRequestParameter
SCTPInfo -> SctpInfo
SCTPMessage -> SctpMessage
SCTPNatEntry -> SctpNatEntry
SCTPNatEntryTable -> SctpNatEntryTable
SCTPNatHook -> SctpNatHook
SCTPNatPeer -> SctpNatPeer
SCTPNatServer -> SctpNatServer
SCTPNatTable -> SctpNatTable
SCTPOpenCommand -> SctpOpenCommand
SCTPParameterTypes -> SctpParameterTypes
SCTPPathCollection -> SctpPathCollection
SCTPPathInfo -> SctpPathInfo
SCTPPathMap -> SctpPathMap
SCTPPathStatus -> SctpPathStatus
SCTPPathVariables -> SctpPathVariables
SCTPPeer -> SctpPeer
SCTPPrMethods -> SctpPrMethods
SCTPQueue -> SctpQueue
SCTPRcvInfo -> SctpRcvInfo
SCTPReceiveStream -> SctpReceiveStream
SCTPReceiveStreamMap -> SctpReceiveStreamMap
SCTPResetInfo -> SctpResetInfo
SCTPRtoInfo -> SctpRtoInfo
SCTPSendInfo -> SctpSendInfo
SCTPSendQueueAbated -> SctpSendQueueAbated
SCTPSendStream -> SctpSendStream
SCTPSendStreamMap -> SctpSendStreamMap
SCTPSerializer -> SctpSerializer
SCTPServer -> SctpServer
SCTPSimpleGapList -> SctpSimpleGapList
SCTPSimpleMessage -> SctpSimpleMessage
SCTPSocket -> SctpSocket
SCTPSocketMap -> SctpSocketMap
SCTPStateVariables -> SctpStateVariables
SCTPStatusInfo -> SctpStatusInfo
SCTPStreamResetChunk -> SctpStreamResetChunk
SCTPStreamResetConstants -> SctpStreamResetConstants
SCTPStreamSchedulers -> SctpStreamSchedulers
